Alejandrina Rosenbalm	role:vice president	subordinates:Dominic Kitson,Tish Muldrew,Hortense Cuneo
Annita Lizaola	role:engineer	subordinates:none
Arlinda Mcqueen	role:director	subordinates:Pearl Dacruz,Doreen Blackwelder
Awilda Deibert	role:engineer	subordinates:none
Barrie Pickard	role:it worker	subordinates:none
Basilia Hochstetler	role:engineer	subordinates:none
Bobbi Gault	role:engineer	subordinates:none
Brandie Steere	role:project lead	subordinates:Latisha Mckenney,Maryam Mabry,Ruthanne Althaus,Olga Creasey
Brice Bello	role:it worker	subordinates:none
Broderick Forsman	role:chief architect	subordinates:Brandie Steere,Eugena Bohnert,Cicely Imai,Diedra Benefield,Kattie Ott
Burma Cermak	role:engineer	subordinates:none
Casie Bulfer	role:engineer	subordinates:none
Cicely Imai	role:engineer	subordinates:none
Clay Veselka	role:engineer	subordinates:none
Clementina Garwood	role:director	subordinates:Reagan Rappold,Yael Meals,Elsie Kohlmeier,Wynell Hedin,Jacqulyn Thill
Clemmie Banker	role:engineer	subordinates:none
Collen Gochenour	role:senior director	subordinates:Davina Benton
Danille Widell	role:engineer	subordinates:none
Darla Polen	role:it worker	subordinates:none
Davina Benton	role:director	subordinates:Dillon Almquist,Brandie Steere,Rosana Smelcer
Dedra Varner	role:engineer	subordinates:none
Delmy Griese	role:engineer	subordinates:none
Denver Mcgoldrick	role:director director	subordinates:Monserrate Smedley,Broderick Forsman
Dewayne Doll	role:engineer	subordinates:none
Diedra Benefield	role:engineer	subordinates:none
Dillon Almquist	role:project lead	subordinates:Delmy Griese,Clay Veselka
Dominic Kitson	role:senior director	subordinates:Clementina Garwood,Simone Weber,Marilynn Schwalb
Dominque Birk	role:senior director	subordinates:Donnie Pinckard
Donnie Pinckard	role:director	subordinates:Kizzie Boedeker,Lajuana Funchess
Doreen Blackwelder	role:project lead	subordinates:Shanae Towler,Bobbi Gault,Diedra Benefield,Lecia Hebron
Edelmira Cutrer	role:senior director	subordinates:Davina Benton
Eden Hee	role:engineer	subordinates:none
Ela Mcfarlane	role:project lead	subordinates:Dewayne Doll,Josphine Granada,Danille Widell,Tomoko Schall,Maryam Mabry
Elene Rosado	role:vice president	subordinates:Whitney Vonruden,Valery Dorado
Elsie Kohlmeier	role:janitor	subordinates:none
Erasmo Masek	role:project lead	subordinates:Eugena Bohnert,Shanae Towler,Latisha Mckenney,Lashaunda Langer,Latonya Shupe
Eugena Bohnert	role:engineer	subordinates:none
Farrah Stanhope	role:engineer	subordinates:none
Gertha Linda	role:project lead	subordinates:Wanita Dawkins,Burma Cermak,Polly Nicola,Lashay Portillo,Lonnie Gelman
Hobert Quintanilla	role:director	subordinates:Brice Bello,Darla Polen,Barrie Pickard,Shaunda Rocca
Hortense Cuneo	role:senior director	subordinates:Tyrell Petitt,Arlinda Mcqueen,Erasmo Masek
Isidra Wilmeth	role:engineer	subordinates:none
Jacqulyn Thill	role:janitor	subordinates:none
Josphine Granada	role:engineer	subordinates:none
Kattie Ott	role:engineer	subordinates:none
Kizzie Boedeker	role:project lead	subordinates:Burma Cermak,Les Sasse,Nikole Whitmore
Lajuana Funchess	role:project lead	subordinates:Dewayne Doll,Myrle Fregoe,Ruthanne Althaus,Annita Lizaola
Lamonica Lewellyn	role:chief architect	subordinates:Wm Straub,Clemmie Banker,Polly Nicola,Danille Widell
Lashaunda Langer	role:engineer	subordinates:none
Lashay Portillo	role:engineer	subordinates:none
Latisha Mckenney	role:engineer	subordinates:none
Latonya Shupe	role:engineer	subordinates:none
Lauralee Mclawhorn	role:engineer	subordinates:none
Lavera Gadd	role:project lead	subordinates:Sherise Tabler,Les Sasse,Torri Lafrance,Shanae Towler,Maryam Mabry,Cicely Imai
Lecia Hebron	role:engineer	subordinates:none
Les Sasse	role:engineer	subordinates:none
Liza Sanks	role:engineer	subordinates:none
Lonnie Gelman	role:engineer	subordinates:none
Loria Bargas	role:chief architect	subordinates:Eugena Bohnert,Les Sasse,Polly Nicola,Latisha Mckenney
Lorraine Corley	role:senior director	subordinates:Broderick Forsman
Marilynn Schwalb	role:director	subordinates:Oren Tawney,Lavera Gadd,Ela Mcfarlane,Doreen Blackwelder
Maryam Mabry	role:engineer	subordinates:none
Mattie Provost	role:engineer	subordinates:none
Mauricio Bonnie	role:director	subordinates:Erasmo Masek,Rosana Smelcer
Melba Pell	role:engineer	subordinates:none
Monserrate Smedley	role:chief architect	subordinates:Josphine Granada,Torri Lafrance,Isidra Wilmeth,Dewayne Doll
Myrle Fregoe	role:engineer	subordinates:none
Nikole Whitmore	role:engineer	subordinates:none
Novella Vire	role:engineer	subordinates:none
Olga Creasey	role:engineer	subordinates:none
Oren Tawney	role:project lead	subordinates:Olga Creasey,Josphine Granada,Lauralee Mclawhorn,Isidra Wilmeth,Eden Hee,Shanae Towler
Pearl Dacruz	role:project lead	subordinates:Lecia Hebron,Eden Hee,Dedra Varner,Mattie Provost
Polly Nicola	role:engineer	subordinates:none
Racheal Rausch	role:vice president	subordinates:Valeri Well,Lorraine Corley,Hobert Quintanilla
Reagan Rappold	role:janitor	subordinates:none
Rosana Smelcer	role:project lead	subordinates:Awilda Deibert,Maryam Mabry
Roxie Sieben	role:project lead	subordinates:Clemmie Banker,Liza Sanks,Farrah Stanhope,Myrle Fregoe,Clay Veselka,Kattie Ott
Ruthanne Althaus	role:engineer	subordinates:none
Samatha Belton	role:engineer	subordinates:none
Shanae Dailey	role:vice president	subordinates:Collen Gochenour,Edelmira Cutrer,Dominque Birk,Denver Mcgoldrick
Shanae Towler	role:engineer	subordinates:none
Sharee Man	role:engineer	subordinates:none
Shaunda Rocca	role:it worker	subordinates:none
Sherise Tabler	role:engineer	subordinates:none
Sherrell Newberry	role:project lead	subordinates:Lauralee Mclawhorn,Ruthanne Althaus,Tomoko Schall,Lonnie Gelman
Shoshana Gatton	role:president	subordinates:Alejandrina Rosenbalm,Shanae Dailey,Elene Rosado,Racheal Rausch		
Simone Weber	role:director	subordinates:Sherrell Newberry,Roxie Sieben,Gertha Linda
Tish Muldrew	role:senior director	subordinates:Mauricio Bonnie,Tyrell Petitt
Tomoko Schall	role:engineer	subordinates:none
Torri Lafrance	role:engineer	subordinates:none
Trang Lorenz	role:project lead	subordinates:Farrah Stanhope,Clay Veselka,Lonnie Gelman,Basilia Hochstetler
Tyrell Petitt	role:director	subordinates:Trang Lorenz,Vicente Gilder
Valeri Well	role:senior director	subordinates:Loria Bargas
Valery Dorado	role:senior director	subordinates:Lamonica Lewellyn,Roxie Sieben
Vicente Gilder	role:project lead	subordinates:Olga Creasey,Les Sasse,Dewayne Doll,Tomoko Schall,Lashaunda Langer,Bobbi Gault
Wanita Dawkins	role:engineer	subordinates:none
Whitney Vonruden	role:senior director	subordinates:Broderick Forsman,Loria Bargas
Wm Straub	role:engineer	subordinates:none
Wynell Hedin	role:janitor	subordinates:none
Yael Meals	role:janitor	subordinates:none
